...........
...........
....@......
...........
...........
...........
..#..#....#
..#.##.#.##
.#......##
.#.##..##
.##..###